▓▓▓▓▓▓▓▓▓▓▓▓▓▓▓▓▓▓▓▓▓▓▓▓▓▓▓▓▓▓▓▓▓▓▓▓▓▓▓▓▓▓▓▓▓▓▓▓▓▓▓▓
▓▓▓▓▓▓▓▓▓▓▓▓▓▓▓▓▓▓▓▓▓▓▓▓▓▓▓▓▓▓▓▓▓▓▓▓▓▓▓▓▓▓▓▓▓▓▓▓▓▓▓▓
▓▓▓▓                                            ▓▓▓▓
▓▓▓▓                                            ▓▓▓▓
▓▓▓▓    ▓▓▓▓▓▓▓▓▓▓▓▓    ▓▓▓▓▓▓▓▓    ████████    ████
▓▓▓▓    ▓▓▓▓▓▓▓▓▓▓▓▓    ▓▓▓▓▓▓▓▓    ████████    ████
▓▓▓▓    ▓▓▓▓                        ████        ▓▓▓▓
▓▓▓▓    ▓▓▓▓                        ████        ▓▓▓▓
▓▓▓▓            ████████    ████████████    ▓▓▓▓▓▓▓▓
▓▓▓▓            ████████    ████████████    ▓▓▓▓▓▓▓▓
▓▓▓▓    ▓▓▓▓    ████▓▓▓▓    ▓▓▓▓▓▓▓▓            ▓▓▓▓
▓▓▓▓    ▓▓▓▓    ████▓▓▓▓    ▓▓▓▓▓▓▓▓            ▓▓▓▓
▓▓▓▓▓▓▓▓▓▓▓▓    ████                    ▓▓▓▓    ▓▓▓▓
▓▓▓▓▓▓▓▓▓▓▓▓    ████                    ▓▓▓▓    ▓▓▓▓
████████████    ████    ▓▓▓▓    ▓▓▓▓    ▓▓▓▓    ▓▓▓▓
████████████    ████    ▓▓▓▓    ▓▓▓▓    ▓▓▓▓    ▓▓▓▓
▓▓▓▓                            ████    ▓▓▓▓▓▓▓▓▓▓▓▓
▓▓▓▓                            ████    ▓▓▓▓▓▓▓▓▓▓▓▓
▓▓▓▓            ▓▓▓▓    ████████████            ▓▓▓▓
▓▓▓▓            ▓▓▓▓    ████████████            ▓▓▓▓
▓▓▓▓▓▓▓▓▓▓▓▓        ▓▓▓▓████▓▓▓▓▓▓▓▓            ▓▓▓▓
▓▓▓▓▓▓▓▓▓▓▓▓        ▓▓▓▓████▓▓▓▓▓▓▓▓            ▓▓▓▓
▓▓▓▓                ▓▓▓▓████                    ▓▓▓▓
▓▓▓▓                ▓▓▓▓████                    ▓▓▓▓
▓▓▓▓▓▓▓▓▓▓▓▓▓▓▓▓▓▓▓▓▓▓▓▓████▓▓▓▓▓▓▓▓▓▓▓▓▓▓▓▓▓▓▓▓▓▓▓▓
▓▓▓▓▓▓▓▓▓▓▓▓▓▓▓▓▓▓▓▓▓▓▓▓████▓▓▓▓▓▓▓▓▓▓▓▓▓▓▓▓▓▓▓▓▓▓▓▓
