▓▓▓▓▓▓▓▓▓▓▓▓▓▓▓▓▓▓▓▓▓▓▓▓▓▓▓▓▓▓▓▓▓▓▓▓▓▓▓▓▓▓▓▓▓▓▓▓▓▓▓▓
▓▓▓▓▓▓▓▓▓▓▓▓▓▓▓▓▓▓▓▓▓▓▓▓▓▓▓▓▓▓▓▓▓▓▓▓▓▓▓▓▓▓▓▓▓▓▓▓▓▓▓▓
▓▓▓▓                                            ▓▓▓▓
▓▓▓▓                                            ▓▓▓▓
▓▓▓▓    ▓▓▓▓▓▓▓▓▓▓▓▓    ▓▓▓▓▓▓▓▓▓▓▓▓▓▓▓▓▓▓▓▓    ▓▓▓▓
▓▓▓▓    ▓▓▓▓▓▓▓▓▓▓▓▓    ▓▓▓▓▓▓▓▓▓▓▓▓▓▓▓▓▓▓▓▓    ▓▓▓▓
▓▓▓▓    ▓▓▓▓            ▓▓▓▓                    ▓▓▓▓
▓▓▓▓    ▓▓▓▓            ▓▓▓▓                    ▓▓▓▓
▓▓▓▓▓▓▓▓▓▓▓▓    ▓▓▓▓    ▓▓▓▓    ████▓▓▓▓▓▓▓▓    ▓▓▓▓
▓▓▓▓▓▓▓▓▓▓▓▓    ▓▓▓▓    ▓▓▓▓    ████▓▓▓▓▓▓▓▓    ▓▓▓▓
▓▓▓▓            ▓▓▓▓    ▓▓▓▓    ████    ▓▓▓▓    ▓▓▓▓
▓▓▓▓            ▓▓▓▓    ▓▓▓▓    ████    ▓▓▓▓    ▓▓▓▓
▓▓▓▓    ▓▓▓▓▓▓▓▓▓▓▓▓▓▓▓▓▓▓▓▓    ████    ▓▓▓▓    ▓▓▓▓
▓▓▓▓    ▓▓▓▓▓▓▓▓▓▓▓▓▓▓▓▓▓▓▓▓    ████    ▓▓▓▓    ▓▓▓▓
▓▓▓▓    ▓▓▓▓                    ████            ▓▓▓▓
▓▓▓▓    ▓▓▓▓                    ████            ▓▓▓▓
▓▓▓▓    ▓▓▓▓    ▓▓▓▓▓▓▓▓▓▓▓▓▓▓▓▓████    ▓▓▓▓▓▓▓▓▓▓▓▓
▓▓▓▓    ▓▓▓▓    ▓▓▓▓▓▓▓▓▓▓▓▓▓▓▓▓████    ▓▓▓▓▓▓▓▓▓▓▓▓
▓▓▓▓    ▓▓▓▓    ▓▓▓▓            ████            ▓▓▓▓
▓▓▓▓    ▓▓▓▓    ▓▓▓▓            ████            ▓▓▓▓
▓▓▓▓    ▓▓▓▓▓▓▓▓▓▓▓▓    ▓▓▓▓▓▓▓▓▓▓▓▓▓▓▓▓    ▓▓▓▓▓▓▓▓
▓▓▓▓    ▓▓▓▓▓▓▓▓▓▓▓▓    ▓▓▓▓▓▓▓▓▓▓▓▓▓▓▓▓    ▓▓▓▓▓▓▓▓
▓▓▓▓                    ▓▓▓▓                    ▓▓▓▓
▓▓▓▓                    ▓▓▓▓                    ▓▓▓▓
▓▓▓▓▓▓▓▓▓▓▓▓▓▓▓▓▓▓▓▓▓▓▓▓▓▓▓▓▓▓▓▓▓▓▓▓▓▓▓▓▓▓▓▓▓▓▓▓▓▓▓▓
▓▓▓▓▓▓▓▓▓▓▓▓▓▓▓▓▓▓▓▓▓▓▓▓▓▓▓▓▓▓▓▓▓▓▓▓▓▓▓▓▓▓▓▓▓▓▓▓▓▓▓▓
